SO ./assets/S_texture
NO ./assets/N_texture
WE ./assets/W_texture
EA ./assets/E_texture

F R,G,B
C R,G,B

111111111111
100001000001
10001N100001
100001000001
111111111111
