SO                                  ./assets/S_texture
NO           ./assets/N_texture
WE                  ./assets/W_texture
EA               ./assets/E_texture
F                                    R,G,B

C                         R,G,B2

1111111111111111111111111
11100N000001
100000000101
100000010001
111111111111