SO ./assets/S_texture
NO ./assets/N_texture
WE ./assets/W_texture
EA ./assets/E_texture

F R,G,B
C R,G,B

111111111111
100N00000011
100000000101
100000010011
111111111111