SO ./assets/S_texture
NO ./assets/N_texture
WE ./assets/W_texture
EA ./assets/E_texture

F R,G,B
C R,G,B

111111111111
100000000011
100000000101
1000000010N1
111111111111