SO                                  ./assets/S_texture
NO           
WE                  ./assets/W_texture
EA               ./assets/E_texture
DO           ./assets/D_texture
F                                    R,G,B

C                         R,G,B2















111111111111
1D00N0000011
100000000101
100000010001
111111111111