
NO ./assets/N_texture
SO ./assets/S_texture
WE ./assets/W_texture
EA ./assets/E_texture

F R,G,B
C R,G,B

111111111111
100000000001
10000N000001
100000000001
111111111111
