NO assets/star_wars_mots/tile025.xpm
SO assets/star_wars_mots/tile012.xpm
WE assets/star_wars_mots/tile027.xpm
EA assets/star_wars_mots/tile010.xpm

C 24,24,24
F 12,12,12

DO assets/star_wars_mots/tile080.xpm

1111111111111111111111111
1011000001110000000000001
1001000000000000000000001
111111111011000001110000111111111
100000000011000001110111111111111
1111H111111111000000000010001
11110111111111011101010010001
110000001101010111000000V0001
10000000000000000000000010001
10000000000000001101010010001
11000001110101011111011110N0111
11110111 1110101 101111010001
11111111 1111111 111111111111
