NO assets/star_wars_mots/tile015.xpm
SO assets/star_wars_mots/tile056.xpm
EA assets/star_wars_mots/tile070.xpm
WE assets/star_wars_mots/tile042.xpm

F 180,180,180
C 20,20,20

1111111111
1000000001
1000N00001
1110000001
1110000001
1000000001
1000000001
1000111101
1000111101
1000111101
1000000001
1000000001
1111100001
1100000001
1101100001
1101100001
1111111111
